##################################################
#................................................#
#..[[[[[..................................]]]]]..#
#..[...[..................................]...]..#
#..[.P.[..................................].p.]..#
#..[...[..................................]...]..#
#..[[[[[..................................]]]]]..#
#................................................#
#................................................#
#.........#######................#######.........#
#.........#.....#................#.....#.........#
#.........#.....#................#.....#.........#
#.........#.....#................#.....#.........#
#.........#######................#######.........#
#................................................#
#................................................#
#................................................#
#................................................#
#................................................#
#................................................#
#................................................#
#................................................#
#................................................#
#................................................#
##################################################
