##################################################
#................................................#
#................................................#
#................................................#
#................................................#
#................................................#
#................................................#
#................................................#
#...................HHHHHHHHHH...................#
#...................HHHHHHHHHH...................#
#...................HHHHHHHHHH...................#
#...................HHHHHHHHHH...................#
#...................HHHHHHHHHH...................#
#...................HHHHHHHHHH...................#
#...................HHHHHHHHHH...................#
#................................................#
#................................................#
#................................................#
#................................................#
#................................................#
#................................................#
#................................................#
#................................................#
#................................................#
##################################################
