##################################################
#................................................#
#................................................#
#................................................#
#.......................$........................#
#................................................#
#................................................#
#................................................#
#.............########################...........#
#.............#€€€€€€€€€€€€€€€€€€€€€€#...........#
#.............#€€€€€€€€€€€€€€€€€€€€€€#...........#
#.............#€€€€€€€€€€€€€€€€€€€€€€#...........#
#.............#€€€€€€€€€€€€€€€€€€€€€€#...........#
#.............#€€€€€€€€€€€€€€€€€€€€€€#...........#
#.............###########..###########...........#
#........................oo......................#
#........................oo......................#
#................................................#
#................................................#
#................................................#
#................................................#
#................................................#
#................................................#
#................................................#
##################################################
